80 17
................................................................................
................................................................................
................................................................................
................................................................................
................................................................................
................................................................................
................................................................................
................................................................................
................................................................................
.........................======================.................................
................................................................................
................................................................................
....................................................==================..........
................................................................................
................................................................!...............
.........................#############################################..........
...............############################################################.....
.....###########################################################################
################################################################################
################################################################################
80 17
................................................................................
................................................................................
................................................................................
................................................................................
................................................................................
.....................................................................$..........
....................................................==================..........
................................................................................
................................................................................
.........................======================.................................
................................................................................
................................................................................
....................................................==================..........
................................................................................
................................................................!...............
.........................################........#####################..........
...............##########################........##########################.....
.....#####################################......################################
##########################################.....!################################
################################################################################
