80 17 16
................................................................................
................................................................................
................................................................................
................................................................................
................................................................................
................................................................................
................................................................................
................................................................................
................................................................................
.........................======================.................................
................................................................................
................................................................................
....................................................==================..........
................................................................................
................................................................!...............
.........................#############################################..........
...............############################################################.....
.....###########################################################################
################################################################################
################################################################################
40 15 10
########################################
..####################################..
....##############################......
.......###################..............
........###############.................
...........###########..................
............#########...................
............#########...................
........................................
........................................
....................!...................
............#########...................
............#########...................
...........###########..................
........###############.................
........###############.................
.......###################..............
.......###################.............!
...#####################################
########################################
80 1 18
................................................................................
#...............................................................................
###.............................................................................
#####.....====..................................................................
######..........................................................................
########........................................................................
############....................................................................
###################..................................====.......................
#################################...............................................
############################################.........!..........................
######################################################..........................
######################################################..........................
#########################################################.......................
###########################################################.....................
############################################################....................
###############################################################.................
####################################################################...####...##
####################################################################...####...##
####################################################################...####...##
####################################################################...####...##
80 10 9
................................................................................
......................=====..====..............=======..=======.................
................................................................................
...........=========................=========...................................
................................................................................
....====..........................................................====..........
................................................................................
.............................................!.........................!........
......................#######..........#######.......!########.......###........
...................######################################################.......
...........################################################################...##
#########..###############################################################....##
######......................................................................####
######.....................................................................#####
#######..................................!..........................############
###############..............#############.............####.......##############
###################.........###############............####......!##############
###################.........#################.....##############################
###################........##################....###############################
###################........##################....###############################
80 16 16
................................................................................
................................................................................
................................................................................
................................................................................
................................................................................
.....................................................................$..........
....................................................==================..........
................................................................................
................................................................................
.........................======================.................................
................................................................................
................................................................................
....................................................==================..........
................................................................................
................................................................!...............
.........................################........#####################..........
...............##########################........##########################.....
##########################################......################################
##########################################.....!################################
################################################################################
80 14 12
................................................................................
................................................................................
................................................................................
................................................................................
................................................................................
................................................................................
................................................................................
................................................................................
................................................................................
................................................................................
......................!.........................................................
...............=============....................................................
...............................................................!................
.................##...................................==================.....###
.................##.....................!............................!.......###
###########..########...##################......################################
###########..########...##################......################################
###########..########...##################......################################
###########..########...##################......################################
###########..########...##################......################################
80 18 0
................................................................................
...........................................................................#####
......................................................................##########
..................$..................!..........................################
................======================...............!##########################
...............................................#################################
..............................................##################################
...............========....................!####################################
...................................#############################################
.=========.....................#################################################
.............................###################################################
...........................#####################################################
......................##########################################################
....................!###########################################################
.........======....#############################################################
..................##############################################################
.................###############################################################
...........!####################################################################
.........#######################################################################
################################################################################
80 15 15
................................................................................
...................................$............................................
............................==============......................................
................................................................................
..............................................!................!................
.........................!....................==================................
................===============.................................................
.......................................==.......................................
................................................................................
................................................................................
............============..................===================...................
................................................................................
.............................========...........................................
.........................................................==============.........
.........=========.......===....................................................
................................................................................
#####......................................................................#####
#####......................................................................#####
#####......................................................................#####
#####......................................................................#####
80 18 17
################################################################################
##............................................................................##
##....................!...................!.................!.................##
##..########################################################################..##
##..########################################################################..##
##........................................................................##..##
##..........!..................!..........................................##..##
########################################################################..##..##
########################################################################..##..##
##........................................................................##..##
##......................................!.................................##..##
##..########################################################################..##
##..########################################################################..##
##........................................................................##..##
##........................................................................##..##
########################################################################..##..##
########################################################################..##....
..........................................................................##....
..................................##........!##..........................#######
################.#########.###########################.#########################
80 18 18
...................................!............................................
...............................#####............................................
............................##########..........................................
........................###################.....................................
......................############################..............................
.........................!#########################.....!.......................
.....................####################################.......................
.................##########################################.....................
..............##############################....................................
...........#############################.........##############.................
..........#######################...............################................
.........#######################.........#!....##################...............
......######################$............#########################..............
......############################...#############################..............
.....#############################......###########################.............
....##############################......############################............
#..###############################......#############################...........
#..###############################......##############################..........
#..###############################!....!###################################.....
#..##################################.##########################################
