40 19 19
........................................
........................................
........................................
........................................
........................................
........................................
........................................
........................................
........................................
........................................
........................................
........................................
........................................
........................................
........................................
........................................
........................................
........................................
........................................
........................................
########################################
########################################
########################################
########################################
80 21 16
................................................................................
................................................................................
................................................................................
................................................................................
................................................................................
................................................................................
................................................................................
................................................................................
................................................................................
................................................................................
................................................................................
............................................................======..............
................................................................................
...................................................====.=====...................
................................................................!...............
.........................#############################################..........
........................###################################################.....
.....................###########################################################
................################################################################
............####################################################################
.........#######################################################################
....############################################################################
################################################################################
################################################################################
40 15 10
########################################
########################################
########################################
..####################################..
....##############################......
.......###################..............
........###############.................
...........###########..................
............#########...................
..............####......................
........................................
........................................
....................!...................
............#########...................
.........############...................
........##############..................
.......################.................
......#################.................
.....#####################..............
....######################.............!
...#####################################
########################################
########################################
########################################
80 4 19
................................................................................
................................................................................
................................................................................
................................................................................
................................................................................
#...............................................................................
###.............................................................................
#####.....====..................................................................
######..........................................................................
########........................................................................
############.........................................======.===.====............
###################.............................................................
#################################............====.====..........................
############################################.........!..........................
######################################################..........................
######################################################..........................
#########################################################.......................
###########################################################.....................
############################################################....................
###############################################################.................
####################################################################.####.##.#.#
####################################################################.####.##.#.#
####################################################################.####.##.#.#
####################################################################.####.##.#.#
80 14 13
................................................................................
................................................................................
................................................................................
................................................................................
................................................................................
...................=======.=====.=............=======.========..................
................................................................................
...........=========................=========.====..............................
................................................................................
....========.....................................................====...........
................................................................................
...........=========............................!......................!........
......................#######..........#######.......!########.......###........
...................######################################################.......
...........#################################################################..##
#########.################################################################...###
######...............#######..#####.###.........###.........................####
######.....................................................................#####
#######..................................!..........................############
###############..............#############.............####.......##############
###################......###############............####......!#################
###################.....################.#....##################################
###################...##################.#######################################
###################...##################.#######################################
80 16 16
................................................................................
................................................................................
................................................................................
................................................................................
................................................................................
.....................................................................$..........
....................................................==================..........
................................................................................
...............................................======...........................
.........................======================.................................
...............................................=................................
................................................====............................
....................................................==================..........
...................................................=............................
................................................................!...............
.........................################........#####################..........
...............##########################........##########################.....
#####.##.##.##############################.#.#.#################################
#####.......!#############################.....!################################
################################################################################
################################################################################
################################################################################
################################################################################
################################################################################
80 18 14
................................................................................
................................................................................
................................................................................
................................................................................
................................................................................
................................................................................
.........................$......................................................
........................==......................................................
................................................................................
.......................====.....................................................
................................................................................
......................======....................................................
................................................................................
...........................=.=.=.=.=.=.=........................................
.........======.......!.....=...................................................
...............=============...................................................#
...............................................................!..............##
.................##...................................==================.....###
................####............#......!#............................!......####
###########.########.#.#####.##.#########.#.#.#.################################
###########.########.#.########..########.#.#.#.################################
###########.########.#.##################.#.#.#.################################
###########.########.#.##################.#.#.#.################################
###########.########.#.##################.#.#.#.################################
80 20 2
................................................................................
................................................................................
................................................................................
...........................................................................#####
......................................................................##########
..................$..................!..........................################
................======.===============...............!##########################
......................=........................#################################
..............................................##################################
.........==.==.========....................!####################################
...................................#############################################
.==========....................#################################################
.............................###################################################
..........=................#####################################################
.........=............##########################################################
....................!###########################################################
.........=========.#############################################################
..................##############################################################
.................###############################################################
...........!####################################################################
.........#######################################################################
################################################################################
################################################################################
################################################################################
80 17 17
................................................................................
................................................................................
................................................................................
...................................$............................................
............................==============......................................
................................................................................
...........................=====..............!................!................
.........................!....................==================................
............==.================.................................................
.......................................==.......................................
...........==...................................................................
................................................................................
............=====.======..................===================...................
................................................................................
.................==..........========...........................................
.........................................................==============.........
.........=========.......===....................................................
................................................................................
#####.====.................................................................#####
#####......................................................................#####
#####......................................................................#####
#####......................................................................#####
#####......................................................................#####
#####......................................................................#####
80 21 20
################################################################################
#########..#####################################################################
########....####################################################################
##.......==...................................................................##
##....................!...................!.................!.................##
##...#######################################################################..##
##=.########################################################################..##
##........................................................................##..##
###.........!..................!..........................................##..##
#######################################################################...##..##
########################################################################.=##..##
##........................................................................##..##
##......................................!................................###..##
##...#######################################################################..##
##=.########################################################################..##
##........................................................................##..##
###.......................................................................##..##
#######################################################################...##..##
########################################################################.=##....
..........................................................................###...
..................................##........!##..........................#######
################.#########.##########......###########.#########################
################.#########.###########....############.#########################
################.#########.###########################.#########################
80 18 22
................................................................................
................................................................................
...................................!............................................
.................................===............................................
...................................!............................................
...............................#####............................................
..............................########..........................................
........................###################.....................................
.....................=############################..............................
.........................!#########################.....!.......................
.....................####################################.......................
.................##########################################.....................
..............##############################....................................
...........#############################.........##############.................
..........#######################...............################................
.........#######################........=#!....##################...............
.......#####################$............#########################..............
......############################.#.#############################..............
.....#############################......###########################.............
#...##############################......############################............
##.###############################......#############################...........
#..###############################......##############################..........
#.################################!....!###################################.....
#..#################################..##########################################

